M  M  M  M  M  M  M  M  M  M  M  M  M  M  M  M  M  M  999
M  0  0  0  M  K000  0  M  O00M  O01M  O020  0  0  M  999
M  0  0  0  M  M  0  0  0  0  0  0  0  0  0  0  0  M  999
M  0  0  0  0  0  0  0  0  0  0  0  0  0  0  0  0  M  999
M  0  0  0  0  0  0  0  0  0  0  0  0  0  0  0  0  M  999
M  0  0  0  M  M  0  0  0  0  0  0  0  0  0  0  0  M  999
M  K01K02K03M  K040  0  M  N00M  N01M  N020  0  0  M  999
M  M  M  M  M  M  C00C01M  M  M  M  M  M  0  0  0  M  999
M  0  0  0  0  M  0  0  M  0  0  0  0  0  0  0  0  M  999
M  0  0  0  0  M  0  0  M  0  0  0  0  0  0  0  0  M  999
M  0  0  0  0  M  0  0  M  0  0  0  0  0  0  0  0  M  999
M  0  0  0  0  M  M  M  M  0  0  0  0  0  0  0  0  M  999
M  0  0  0  0  0  0  0  0  0  0  0  0  0  0  0  0  M  999
M  M  M  M  M  M  M  M  M  M  M  M  M  M  M  M  M  M  999
$$$
M  M  M  M  M  M  M  M  M  M  M  M  M  M  M  M  M  M  999
M  0  0  0  0  0  0  0  0  0  0  0  0  0  0  0  0  M  999
M  0  0  0  0  0  0  0  0  0  0  0  0  0  0  0  0  M  999
M  0  0  0  0  0  0  0  0  0  0  0  0  0  0  0  0  M  999
M  0  0  0  0  0  0  0  0  0  0  0  0  0  0  0  0  M  999
M  0  0  0  0  0  0  0  0  0  0  0  0  0  0  0  0  M  999
M  0  0  0  0  0  0  0  0  0  0  0  0  0  0  0  0  M  999
M  0  0  0  0  0  0  0  0  0  0  0  0  0  0  0  0  M  999
M  0  0  0  0  0  0  0  0  0  0  0  0  0  0  0  0  M  999
M  0  0  0  0  0  0  0  0  0  0  0  0  0  0  0  0  M  999
M  0  0  0  0  0  0  0  0  0  0  0  0  0  0  0  0  M  999
M  0  0  0  0  0  0  0  0  0  0  0  0  0  0  0  0  M  999
M  0  0  0  0  0  0  0  0  0  0  0  0  0  0  0  0  M  999
M  M  M  M  M  M  M  M  M  M  M  M  M  M  M  M  M  M  999
$$$
